=LoadAllPostsServlet
firstLoginPage=login.html
loginPage=login.jsp
contentPage=contentPage.jsp
createCategoryPage=createCategory.jsp
homePage=index.jsp
createPostPage=createPostPage.jsp
pendingPostListPage=pendingPostsList.jsp
postWaitingApprovalPage=postWaitingApproval.jsp
profilePage=profilePage.jsp
registerPage=register.jsp
searchResultPage=searchResult.jsp
userListPage=userListPage.jsp
messengerPage=messengerPage.jsp
notFoundPage=notFoundPage.jsp
updatePostPage=updatePostPage.jsp
userListResultPage=resultpage.jsp
awardDashboardPage=awardDashboard.jsp
rejectedPostsPage=rejectedPostsPage.jsp
rejectedPostsContent=rejectedPostsContent.jsp
commentManagementPage=commentManagementPage.jsp
login=LoginServlet
loginGoogle=LoginGoogleServlet
loadBlogs=LoadAllPostsServlet
searchTitle=SearchTitleServlet
loadPendingPosts=LoadPendingPostServlet
loadPostContent=LoadPostContentServlet
logout=LogoutServlet
register=RegisterServlet
createPost=CreatePostServlet
loadProfile=LoadProfileServlet
createCategory=CreateCategoryServlet
searchByCategory=SearchCategoryServlet
searchByTag=SearchByTagServlet
loadContentPendingPost=LoadContentPendingPostServlet
approvePost=ApprovePostServlet
loadUserList=LoadUserListServlet
searchFilt=SearchFilteringServlet
userAction=UserListActionServlet
deletePost=DeletePostServlet
comment=CommentServlet
loadOldContent=LoadOldContentServlet
updatePost=UpdatePostServlet
likePost=LikePostServlet
deleteComment=DeleteCommentServlet
editComment=EditCommentServlet
loadDashboard=LoadAwardDashboardServlet
giveAward=GiveAwardServlet
loadRejectedPosts=LoadRejectedPosts
loadRejectedContent=LoadRejectedContentServlet
loadAllComments=LoadAllCommentsServlet
